1111111
1PC0E11
1111111
1111111