11111111111111111111111111111111111111
10000000C000000001100000C0C00000011111
10010111110000011110010111110000011111
10010000C0000P000000010000C00000011111
1001000000000E011110010000000000011111
10001111101100000C00001111101100000C11
11111111111111111111111111111111111111
