11111
1P0E1
11111
11C11
11111