111111111111111
1ECCCCCCCCCCCP1
111111111111111